*****************
*   *   *PP     *
* * *P* * ***** *
* * * * * *   * *
* * * *** * * * *
* * *   * * *   *
* * * * * * *****
* * * * *G*   * *
* *** * *** * * *
*    P*     * * *
* *** * *** * * *
* *   * *   *   *
*** ***** *** * *
*   *    P    * *
* *** ********* *
*    S          *
*****************