*****************
*   *   *pp     *
* * * * * ***** *
* * * * * *   * *
* * * *** * * * *
* * *   * * *   *
* * * * * * *****
* * * * *t*   * *
* *** * *** * * *
*     *     * * *
* *** * *** * * *
* *   * *   *   *
*** ***** *** * *
*   *    p    * *
* *** ********* *
*    s          *
*****************