******************
*   *   *       **
* * * * * ***** **
* * * * * *   * **
* * * *** * * * **
* * *   * * *   **
* * * * * * ******
* * * * *t*   * **
* *** * *** * * **
*     *     * * **
* *** * *** * * **
* *   * *   *   **
*** ***** *** * **
*   *         * **
* *** ********* **
*    s          **
*****************