 , ,6,9, , , ,4, 
 ,9, , ,6,5, , , 
5, ,7, , ,3, ,9, 
 , , , ,4,1, , , 
 , , ,3,9, , , , 
4,2, , , , , ,5,1
 ,4, ,2, , ,3, ,6
 , , ,1,3, , ,7, 
 ,3, , , ,8,5, , 
