8,1,7,2,9,5,3,6,4
9,3,4,6,1,8,2,7,5
2,6,5,7,4,3,1,9,8
4,7,6,8,3,2,5,1,9
5,9,3,1,7,4,6,8,2
1,8,2,9,5,6,7,4,3
6,4,8,3,2,7,9,5,1
7,2,9,5,8,1,4,3,6
3,5,1,4,6,9,8,2,7
