2,8,9,5,4,7,3,6,1
1,5,4,3,8,6,9,2,7
7,6,3,1,2,9,5,8,4
6,1,8,9,5,2,4,7,3
3,9,5,7,6,4,8,1,2
4,7,2,8,1,3,6,5,9
5,3,7,6,9,1,2,4,8
8,4,1,2,3,5,7,9,6
9,2,6,4,7,8,1,3,5
