3,1,6,9,2,7,8,4,5
2,9,4,8,6,5,1,3,7
5,8,7,4,1,3,6,9,2
8,6,9,5,4,1,7,2,3
1,7,5,3,9,2,4,6,8
4,2,3,7,8,6,9,5,1
7,4,1,2,5,9,3,8,6
6,5,8,1,3,4,2,7,9
9,3,2,6,7,8,5,1,4
