 ,8,9, , , , , ,1
 , , ,3, ,6, ,2, 
 , , , , , , , , 
6, , , , , , , , 
3, , ,7, , , , , 
 , , , ,1, , , ,9
 , ,7, ,9, , , ,8
 , ,1, , , , , , 
 , , ,4, , , ,3, 
