 ,1, ,2,9,5,3,6, 
9,3,4, , , , , , 
 , , ,7,4, ,1, ,8
 ,7, , ,3, ,5, , 
 ,9, ,1,7,4,6,8,2
1,8,2, , , ,7, , 
6, , ,3, ,7, ,5, 
 ,2,9,5,8,1,4,3,6
 ,5,1,4,6,9,8,2, 
